NO ./test/images/NO.xpm
SO ./test/images/SO.xpm
WE ./test/images/WE.xpm
EA ./test/images/EA.xpm

F 220,100,0
C 225,30,0

     1111111111111111111111111
     1000000000110000000000001
     1011000001110000000000001
     10010000000000000000000011111111
 111111111101100000111000000000000001
1000000000110000011101111111111111111
11110111111111011100000010001
11110111111111011101010000001
110000001101010010001111111111111
10000000      0000000000001000001
100000000000000011010100100011111
1100000111010101111101111000111
11110111 1110101 100011000000
11111111 1110111 111111111111
           101  
            1 