     1111111111111111111111111
     1000000000110000000000001
     1011000001110000000000001
     10010000000000000000000011111111
 111111111101100000111000000000000001
1000000000110000011101111111111111111
11110111111111011100000010001
11110111111111011101010000001
110000001101010100000000100011
100000000000000000000001000001
100000000000000011010100100011
1100000111010101111101111000111
11110111 1110101 100011000000
11111111 1110111 111111111111
           101  
            1 