F 220,100,0

NO ./test/images/NO.xpm
SO ./test/images/SO.xpm
WE ./test/images/WE.xpm
EA ./test/images/EA.xpm


C 225,30,0

        1111111111111111111111111
        1000000000000000000000001
        1000000000000000000000001
111111111000000000000000000000001
10000000000000000000000000000111
10000000000000E10000000000001
10000000000000000000000000001
10000000000000000000000000001    
10000000000000000000000000001
10000000000000000001010000001     
11000001110101011111011110101
11110111 1110111 101111010001   
11111111 1111111 111111111111
